30
XXXXXXXXXXXXXXXXXXXXXXXXXXXXXX
XS                          XX
XXX XXX XXXXXXXXXXXXXXXXXXX XX
XXX XXX XXXXX XXXXXXXXX XXX XX
XXX XXX XXXXX           XXX XX
XXX X     XXX XXXXXXXXXXXXX XX
XXX XXXXXXX                 XX
XXX XXXXXXXXXXXXXXXXXXXXXXX XX
XXX                     XXX XX
XXXXXXXXXXXXXXXXXXXXXXXXXXX XX
XXXX                        XX
XXXX XXXXXXXXXXXXXXXXXXX XXXXX
XX                   XXX XXXXX
XX XXXXXX XXXXXXXXXX        XX
XX XX       XXXXXXXX XXXXXX XX
XX XX XXX XXXX       XX  XX XX
XX XX XXX XXXX XXXXXXXX XXX XX
XX XX XXXXXXXX XXXXXXXX     XX
XX          XX        XXXXX XX
XXXXXXXXXXXXXX XXXXXXXXXXXX XX
XXXXX          XXXX         XX
X     XXXX XXXXX  XXXXXXXXX XX
X XXX X       XXX           XX
X XXX XXXXXXXXXXXXXXXXXXXXXXXX
X XXX                         
X XXXX XXXXXXXXXXXXXXXXXXXX XX
X X      XX        XXXXXXXX XX
X XXXX XXXX XXXXXXXX        XX
X           X        XXXXXXXXX
XXXXXXXXXXXXX XXXXXXXXXXXXXXXX
15
X XXXXXXXXXXXXX
X             X
X XXXXXXXXXXX X
X X         X X
X X XXXXXXX X X
X X X     X X X
X X   XXX X X X
X X X XS  X X X
X X X XXX X X X
X X X     X X X
X X XXXXXXX X X
X X         X X
X XXXXXX XXXX X
X             X
XXXXXXXXXXXXXXX
10
XXXXXXXXXX
X   S    X
X X X XX X
X        X
X X X X XX
X        X
X XX XX XX
X XX XX XX
X       XX
XX XXXXXXX
25
X XXXXXXXXXXXXXXXXXXXXXXX
X X          XXX      XXX
X XXXXXXXXXX XXX XXXX XXX
X X    XXXXX XXXXXXXX XXX
X XXXX XXXXX          XXX
X XXXX XXXXX XXXX XXXXXXX
X XXXX    XX XXXX XXXX XX
X XXXX XXXXX XXXX XXXX XX
X X    XXXXX XXXX XXXX XX
X XXXX XXXXX   XX XXXX XX
X            XXXX      XX
XXXXXXXXXXXX XXXXXXXXXXXX
X                   XXXXX
X XXXXXXXXXXXXXXXXX XXXXX
X X          XXXXXX XXXXX
X XX XXXXXXX XXXXXX XXXXX
X XX XSXXXXX XXXXXX XXXXX
X XX X XXXXX     XX XXXXX
X XX X XXXXX XXXXXX XXXXX
X XX X X     XXXXXX XXXXX
X XX X XXXXX XXXXXX XXXXX
X XX X XXXXX     XX XXXXX
X    X XXXXXXXXXXXX XXXXX
XXXXXX              XXXXX
XXXXXXXXXXXXXXXXXXXXXXXXX
8
X XXXXXX
X XX   X
X XX XXX
X      X
XXX XX X
X X XX X
X   XXSX
XXXXXXXX